R 1920 1080
NO ./path_to_the_north_texture
SO ./path_to_the_south_texture
WE ./path_to_the_west_texture
EA ./path_to_the_east_texture

S ./path_to_the_sprite_texture
C 220,100,2
F 225,30,12

111111
10000111111111
11110000000001
111111111W0001
11111111111111
